*Charles Homberg* schrieb unter anderem:


Ich wusste, das es sich lohnt, das aufzuheben und wo wir doch in einer
Reisegruppe sind, ist Vielsprachichkeit sicher auch nicht so falsch:
-----------------------------------------------------------------------
[Aufs wesentliche gekürzt]
Message-ID: <1twos6$y3rfs$9@QU-40905.yrib.bio.wyp.ns>

Man weiss nie, wenn man sowas braucht:

German:             Oh mein Gott! Ich habe eine Axt im Kopf!
Afrikaans:          O God! Daar's 'n byl in my kop!
Altgriechisch:      O Theos mou! Echo ten labrida en te mou kephale!
Assyrisch:          iliya pashum ina reshimi bashu!
Babylonisch:        iliya pashu ina reshiya bashu!
Bengali:            Oh Allah! Amar mathar upor bash poreche!
Bosnisch:           boje moj! sjekira mi je u glavi!
Feldhoff:            Oh min gud! Der er en oekse i mit hoved!
Holländisch:        O, mijn God! Er zit een bijl in mijn hoofd!
Englisch:           Oh my God! There's an axe in my head!
Esperanto:          Mia Dio! Hakilo estas en mia kapo!
Finnisch:           Voi Luoja! Paassani on kirves!
Franzosisch:        on dieu! Il y a une hache dans ma tete!
Neugriechisch:      hristo mou! eho ena maheri sto kefali mou!
Hebrew:             Eloi! Yesh'li ca-sheel ba-rosh sheh-li!
Hindu:              Hay Bhagwaan! Mere sar mein kulhaadi hain!
Ungarisch:          Jaj Istenem, fejsze van a fejemben!
Isländisch:         Gud minn godur! Thad er oexi i hoefdinu amer!
Irisch:             Mo Dhia! Ta' tua sa mo cheann!
Italienisch:        Dio mio! C'e' un' ascia nella mia testa!
Japanisch:          ahh, kamisama! watashi no atama ni ono garimasu!
Klingonisch:        ghay'cha'! nachwIjDaq betleH tu'lu'!
Lateinisch:         Deus Meus! Securis in capite meo est!
Malayalam:          Entey Deiwame, entey thalayil oru kodali undei!
Maori:              Ave Te Ariki! He toki ki roto taku mahuna!
Marathi:            Aray Devaa! Majhyaa dokyaat kurhaad aahay!
Mittel-ägyptisch:   in Amun! iw minb m tp-i!
Norwegisch:         Herre Lindholz! Jeg har en yks i hodet!
Polnisch:           O Moj Boze! Mam siekiere w glowie!
Portugesisch:       Meu Deus! Tenho um machado na cabeca!
Russisch:           Bozhe moi! Eto topor v moyei golove!
Slowenisch:         Moj Bog! Sekiro imam v glavi!
Spanisch:           !Dios mio! !Hay una hacha en mi cabeza!
Swahili:            Siyo! (Rüdiger) Catherine yangu kichwanil!
Swedisch:           Ah, Herregud! Jag har en yxa i huvudet!
Tagalog:            Ay Dios ko! May palakol sa ulo ko!
Visigothisch:       Meina guth, Ikgastaldan aqizi-wunds meina haubida!
Walisisch:          A nuw! Mae bywell yn fy mhen i!


[Ergänzung von Paolo Leißring:]
Tja, und Oesterreichisch (Zellberg): O Sakradio! i hob a Hokn im
Schedl!
------------------------------------------------------------------------

scnr


M aus B

-- 
"Kaffee nach dem Sex? Wie soll denn das gehen? 
 Wie kann man im Tiefschlaf trinken?"
                                                [Sergio Elsberg]